##XX##########XX##
..................
....oooooooooo....
..................
W...W..o.o.......W
W...W..o.o...WWW.W
W......o.o.......W
W...W........WWW.W
W...W..o.o.......W
W......o.o...WWW.W
W...W..o.o.......W
W...W........WWW.W
W...W..o.o.......W
W......o.o...WWW.W
W...W..o.o.......W
W...W........WWW.W
..................
##################

texturescale: 1,
fPlayerX = 1.0;
fPlayerY = 2.0;
fPlayerA = 1.5;