#############..#
#...........U..#
#...W.......U..#
#...W.......U..#
#...W..........#
#...W........o.#
#............o.#
#......##....o.#
#......##....o.#
#..............#
#.......$$$$$$$#
#..............#
#..ooooooo.....#
#..............#
#....T.T....T.T#
######X#....#X##