#############..#
#...........#..#
#...........#..#
#...........#..#
#########...#..#
#..............#
#..............#
#..............#
#....WUUUU.....#
#....W.........#
#....W.........#
#....W.......o.#
#....T.T.......#
######.#########
...............#
................
................
...ooooooo......
................
................
................
...####XX#####..
...#...TT....#..
...#.........#..